12

desalination - nationalised
Aristotelian - retaliations
Prince Albert - printer cable
coalitionist - solicitation
benign tumour - outnumbering
counterspies - persecutions
computer user - Supreme Court

eating places - special agent
adulterating - triangulated
obscurantist - subtractions
scapegoaters - storage space
chicory plant - lycanthropic
encroachment - technomancer
dominatrices - romanticised
edible fruits - filibustered

---

13

antiparticles - paternalistic
starting point - trainspotting

containerised - inconsiderate
conservatoire - overreactions
orchestra pits - stratospheric
relationships - rhinoplasties
chemical agent - climate change
commercialist - microclimates
operating cost - prognosticate

---

14


propitiousness - superpositions
cutting corners - reconstructing
predictiveness - vice presidents

---

15

magnetic iron ore - microgeneration